##########
#b  X   X#
#        #
# pC     #
#        #
# P    # #
#  C   #C#
#     O# #
#  X    E#
##########
